####--E--####
#--%-###-%--#
#--#--#--#--#
#-#-------#-#
#-###---###-#
#---%---%---#
#-###---###-#
#-#%%%%%%%#-#
#-##-----##-#
#--%--%--%--#
#--#--#--#--#
#--%-###-%--#
####--B--####